.................
....x.......x....
.................
.......x.x.......
.................
.....x.....x.....
........y........
.................
.......x.x.......
.................
....x.......x....
.................
...x.............
....x............
.....x......y....
......x..........
.................
.............x...
............x....
....y......x.....
..........x......
.................
.................
....y.......y....
.................
.....x.x.x.x.....
.................
..xxx.......xxx..
.................
......x.x.x......
.................
.................
....y.x.x.x.y....
.................
.................
.....x.x.x.x.....
........y........
.................
......x...x......
.....x.....x.....
....x.......x....
...x....y....x...
.................
.................
....y...y...y....
......y...y......
.................
.................
.................
.................
-
